111111111111111111
1P0000000000000001
111111011111111101
1C00000010000000E1
101111111011111101
1C0000000000000001
111111111111111111
