111111111111111
1P0000100000001
101110101111111
1C00010100000E1
101111100011111
1C0000001000001
111111111111111
