11111111
1P000C11
11110111
1C000001
100011E1
11111111
