1111111111111
1P000000000E1
1011101111101
1C010000001C1
1010111110101
1C00000000001
1111111111111
