111111111111
1P00000000E1
101111111101
1C00000000C1
111111101111
1C0000000001
111111111111
