1111111111111
1P000001000E1
1011110011001
1C001000C0011
1111011111011
1C00000000011
1111111111111
