11111111
1P000001
101110C1
1C0010E1
11111111
