111111111
1P0000001
101111101
1C01010E1
101010101
1C0000001
111111111
