1111111111
1P00000001
1011101111
1C000000C1
1011101111
1E00000001
1111111111
