1111111111111111
1P000000000000E1
1011111011111101
1C000C0000000C01
1011111111111101
1C00000000000001
1111111111111111
