1111111111111
1P000000000E1
1110111011101
1C000100000C1
1011101111101
1C00000000001
1111111111111
