11111111111111111
10000C000000C0011
10010111110000011
1001010P100000011
1E0100010000C0011
11111111111111111