1111111111111
1001000000001
1000011111001
1P0011E1C0001
1111111111111