1111111111111111111
1P0000C000000001111
1001011111000001111
1001010010000001111
1E0100110000C001111
1000111110110000001
1111111111111111111