1111111111111111111
10000C000000C001111
1001011111000001111
1001010P10000001111
1E0100010000C001111
1000111110110000001
1111111111111111111